TILEMAP
533 32			-- Size of map in tiles
8			-- Size of tiles in pixels
images/00_level1_scenario.png			-- Scenario file
ENEMY_DEF
1 -- Number of definitions
A 2 2 180 0 2 45 1 -- Standard RedPlan
                     11111111111111111111111111111111111                                              1111111111111111111                           111111111111111111111111111111111111111111111111111111111111    11111111111111111111111111111111111111111111111111111111111111111111111111111111                                                                                                                                         1111111111111111111111111111111111111111111111111111      1111111111111111111111111111111111111111111111
                                                                                                       111111111111111111                                       111111111111                  111111                      111111111111111111111111                1111111111111111111111111111111111                                                                                                                                         1111111111111111111111111111111111                                              111111111111111111111111
                                                                                                        111111111 11111                                          11111111111                  111111                      111111111111111111111111                1111111111111111111111111111111111                                                                                                                                         11111111111111111111111111111111                                                111111111111111111111111
                                                                                                                                                                 11111111111                                                  111    11    111                    1111111111111111111111111111111111                                                                                                                                         11111111111111111111111111111111                                                111111111111111111111111
                                                                                                                                                                  1111111111                                                                                      1111111111111111111111111111111111                                                                                                                                          11  11  11  11  11   111111111                                                 111111111111111111111111
                                                                                                                                                                   111111111                                                                                      1111111111111111111111111111111111                                                                                                                                                               11111111                                                  111111111111111111111111
                                                                                                                                                                   111111111                                                                                      1111111111111111111111111111111111                                                                                                                                                               1111111                                                   111111111111111111111111
                                                                                                                                                                   111111111                                                                                      111111111                   111111                                                                                                                                                                1111                                                     111111111111111111111111
                                                                                                                                                                   111111111                                                                                      111111111                   111111                                                                                                                                                                                                                         111111111111111111111111
                                                                                                                                                                   111111111                                                                                      111111111                   111111                                                                                                                                                                                                                                                 
                                                                                                                                                                                                                                                                                                                                                                                                                                                                                                                                                     
                                            A                                                                                                                                                                                                                                                                                                                                                                                                                                                                                                        
                                                                                                                                                                                                                                                                                                                                                                                                                                                                                                                                                     
                              2                                                                                                                                                                                                                                                                                                                                                                                                                                                                                                                      
                                                                                                                                                                                                                                                                                                                                                                                                                                                                                                                                                     
                                                                                                                                                                                                                                                                                                                                                                                                                                                                                                                                                     
                                                                                                                                                                                                                                                                                                                                                                                                                                                                                                                                                     
                                                                                                                                                                                                                                                                                                                                                                                                                                                                                                                                                     
                                                                                                                                                                                                                                                                                                                                                                                                                                                                                                                                                     
                                                          2                                                                                                                                                                                                                                                                                                                                                                                                                                                                                          
                                                                                                                                                                                                                                                                                                                                                                                                                                                                                                                                                     
                                                                                                                                                                                                                                                                                                                                                                                                                                                                                                                                                     
                                                                                                                                                                   111111111                                                                                                                                                                                                                                                                                                                                                                         
                                                                                                                                                                   111111111                                                                                                                                                                                                                                                                                                                                                 111111111111111111111111
                                                                                                                                                                   111111111                                                                                                                  111111                                                                                                                                                                1111                                                     111111111111111111111111
                                                                                                                                                                   111111111                                                                                                                  111111                                                                                                                                                               1111111                                                   111111111111111111111111
                                                                                                                                                                   111111111                                                                                                                  111111                                                                                                                                                               11111111                                                  111111111111111111111111
                                                                                                                                                                  1111111111                        111111                                                        111111                      111111                                                                                                                                          11  11  11  11  11   111111111                                                 111111111111111111111111
                                                                                                                                                                 11111111111                        111111                    111    11    111                    111111                      111111                                                                                                                                         11111111111111111111111111111111                                                111111111111111111111111
                                                           111111111 11111                                             1111                                      11111111111                        111111                111111111111111111111111                111111                      111111                                                                                                                                         11111111111111111111111111111111                                                111111111111111111111111
                                                          111111111111111111                                          111111                                    111111111111                        111111                11111111111111111111111111111      1111111111111111            11111111111                                                                                                                                         1111111111111111111111111111111111                                              111111111111111111111111
                                                          1111111111111111111                                         111111                        111111111111111111111111111111111111111111111111111111111111111111111111111111111111111111111111111111111111111111111111111111111111111111111111                                                                                                                                         1111111111111111111111111111111111111111111111111111111111111111      1111111111111111111111111111111111
