TILEMAP
60 32 							-- Size of tile map in tiles
8 8 							-- Tile size & block size
images/ruins_scenario_s1.png 	-- Tilesheet
111111111111111111111111111111111111111111111111111111111111
1     1111  111111111111                                   1
1     1111   11111111111                                   1
1            11111111111                                   1
1             1111111111                                   1
1              111111111                                   1
1              111111111                                   1
1              111111111                                   1
1              111111111                                   1
1              111111111                                   1
1                                                          1
1                                                          1
1                                                          1
1                                                          1
1                                                          1
1                                                          1
1                                                          1
1                                                          1
1                                                          1
1                                                          1
1                                                          1
1                                                          1
1              111111111                                   1
1              111111111                                   1
1              111111111                                   1
1              111111111                                   1
1              111111111                                   1
1             1111111111                                   1
1            11111111111                                   1
1     1111   11111111111                                   1
1     1111  111111111111                                   1
111111111111111111111111111111111111111111111111111111111111